11111111111111111111
10000000001000000001
10000000000001010101
11110000110001011101
10010000110011000001
10000000000001000001
10000000000001100111
11100001110000000101
10000001000000000001
10000000000000111001
10001000000001000001
10001000000010000001
10011000001110001001
10010000000100001001
11111111111111111111